110
1 1 1 1 0 1 1 1 1 1 0 1 1 1 1 1 1 1 1 1
2 2 2 2 2 2 2 2 2 2
2 2 2 2 2 2 2 2 2 0 2 2 0 0 0
0 1 1 1 1 1 1 0 1 0 0 0 0 0 0
0 0 0 0 0 1 0 0 1 0 1 1 1 1 1 0 1 1 1 1
1 2 2 2 2 2 0 0 0 3 3 3 3 3 3 3 3 3 3 3
4 4 4 3 3 4 4 4 4 3
15
16
17
18
19
20
21
22
23
24
39
54
69
84
83
82
81
80
79
78
77
92
107
122
137
138
139
140
141
142
143
144
145
146
161
176
191
206
205
204
203
202
201
216